111111
1W0001
100001
100001
100001
100001
101001
111111