111111
1N0001
100001
100001
100001
100001
101001
111111