111111
10P001
100001
100001
111111